        1111111111111111111111111
        1000000000110000000000001
        1011000001110000002000001
        1001000000000000N00000001
111111111011000001110000000000001
100000000011000001110111111111111
11110111111111011100000010001
11111111111111111111111111111